페텔기우스	분탕
주지태	도배 및 분탕
.	분탕
어둠의 사도 이예준	특수 사유
나(사회주의)	민감 주제 경고 누적
씹뜨억, 후, 마술에 걸린 마술사 마호짱	분탕
레이	채팅방 분위기
응우옌	분탕
멍멍	분탕
멍멍이 주인	분탕
에밀리아 뽀뽀	분탕
고새	분탕
노머고	분탕
무고통	분탕
박찬우	카프 및 분탕
박잼민	분탕
하렘	카프 및 분탕
토모에짱♡	카프
임정연	분탕
하앙	분탕
병아리	카프
ㅎㅎ	카프
karl-heinz Rummenige	어그로
마법소녀 노무현	분탕
명붕이	카프
기억하자	입장 후 미응답
타쿠와	삼인조 분탕
미쿠짱	삼인조 분탕
닉네임	삼인조 분탕
무노현웩스식	분탕
리트	특수 사유
돈돈돈	입장 후 미응답
이민용	분탕
라면스프	입장 후 미응답
바피	입장 후 미응답
IrM	입장 후 미응답
나이스 네이처	카프
마구로	카프
유미가 좋다능	카프
니마음천안함폭격	분탕
골라주세요오	입장 후 미응답
피넛	분탕
아스카 키라라모띠	분탕
사쿠라 유이리모찌	분탕
고덕	카프
한솔	카프
기미식	카프
업짱	카프
샤이닝	카프
(닉네임 기입 부적합)	사칭 어그로