이민지	입장 후 미응답
루리봉	입장 후 미응답
전영일	입장 후 미응답
Mario	특수 사유
윾피네	야짤
12116(민서)	카프
일본 만세	특수 사유
かれがカレーを	분위기 및 종교적 이슈
카후 치노	채팅방 분위기
흥	채팅방 분위기
네미	특수 사유
원신	카프
옹	카프
박은미	카프
이박사	카프
황예람	입장 후 미응답
이승준	특수 사유
yee	입장 후 미응답
이사과!	분위기
한새봄	분위기